39
11
***************************************
*   * *B      *           *    B*     *
*** * ***** *** * *** *** *** ***** * *
*   * *#*       *B* *   *B* *       * *
* * * * * * *** *** *** *** * ***** * *
*B*       * *     *         *   * *B*B*
***** ***** *** * * *** * * * *** *****
*     *B*B* *   *B*   *B* *   *   *  B*
*** *** * * * * *** * *** *** * * * ***
*B  *         *     *           *  $$$@
***************************************